111111111111111111111111
161700010001000000000001
101111000100010111111101
100001111102011100000101
101101000100010001110101
105100010001000111400131
111111111111111111111111