11111111111111111
1a110000000011101
10000111011003101
11011110001111101
10000000500000001
10101110201111101
111000110110b1101
14001000000000001
11111111111111111