1111111111111
1311514160011
1011010111001
1001010021101
1100000100001
1111111111111