111111111
100020001
101151101
101314101
101010101
101010101
101010101
101010101
100010001
111111111